Onyx
An Interactive Fiction
Release 1 / Serial number 160326 / Inform 7 build 6M62 (I6/v6.33 lib 6/12N) SD

Deep Forest
You are lost in a deep forest. The trees grow so close together that you cannot see the sun or the sky, and no grass or small plants thrive on the ground. 你迷失在一个幽静的森林里，繁茂的树木甚至遮住了太阳和天空，地上不长草也没有其他小型植物

>cut
(the magic ball)
Cutting it up would achieve little.

>fuck
That's not a verb I recognise.

>shit
That's not a verb I recognise.

>did
That's not a verb I recognise.

>do
That's not a verb I recognise.

>hack
That's not a verb I recognise.

>run
You'll have to say which compass direction to go in.

>change
That's not a verb I recognise.

>sit
(on the magic ball)
That's not something you can sit down on.

>kill
(the magic ball)
Violence isn't the answer to this one.

* * *

Onyx
An Interactive Fiction
Release 1 / Serial number 160326 / Inform 7 build 6M62 (I6/v6.33 lib 6/12N) SD

Deep Forest
You are lost in a deep forest. The trees grow so close together that you cannot see the sun or the sky, and no grass or small plants thrive on the ground. 你迷失在一个幽静的森林里，繁茂的树木甚至遮住了太阳和天空，地上不长草也没有其他小型植物

>i
You are carrying:
  a magic ball
  a fucking ball

>drop ball
Which do you mean, the magic ball or the fucking ball?

>fucking ball
Dropped.

>l
Deep Forest
You are lost in a deep forest. The trees grow so close together that you cannot see the sun or the sky, and no grass or small plants thrive on the ground. 你迷失在一个幽静的森林里，繁茂的树木甚至遮住了太阳和天空，地上不长草也没有其他小型植物 

You can see a fucking ball here.

* * *

Onyx
An Interactive Fiction
Release 1 / Serial number 160326 / Inform 7 build 6M62 (I6/v6.33 lib 6/12N) SD

Deep Forest
You are lost in a deep forest. The trees grow so close together that you cannot see the sun or the sky, and no grass or small plants thrive on the ground. 你迷失在一个幽静的森林里，繁茂的树木甚至遮住了太阳和天空，地上不长草也没有其他小型植物

>l
Deep Forest
You are lost in a deep forest. The trees grow so close together that you cannot see the sun or the sky, and no grass or small plants thrive on the ground. 你迷失在一个幽静的森林里，繁茂的树木甚至遮住了太阳和天空，地上不长草也没有其他小型植物

>i
You are carrying:
  a magic ball

>x ball
Whenever you drop this, it rolls in the way you should go. 当你扔下这只魔法球时，它会向你该去的方向滚动。

>w
Baba Yaga's Garden
In this garden grow plants that eat insects and plants that eat birds. It is bordered by a bone fence, and the pavements are made of a giant's kneecaps. 花园里长了可以吃昆虫的食肉植物还有吃鸟的植物，这些植物周围用白骨做的篱笆围住，小路是用巨人的膝盖骨铺的。

In the center of the garden is Baba Yaga's hut, which walks on chicken legs. Currently the hut is squatting on the ground. 花园中间是Baba Yaga的小棚屋，屋子长了一双鸡的腿，现在正蹲在地上

>x m
You can't see any such thing.

>x me
Some people call you Ivan the Fool, but you pay no attention to their rudeness. 有些人会喊你傻Ivan，但是你无视了这些粗言。

>in
Baba Yaga's Hut
From in here, there is no evidence of the hut's chicken nature except that the wallpaper is made of yellow-white feathers. 看起来除了用黄白相间的羽毛做的墙纸，并没有什么证据表明这个棚屋原来是一只鸡 

One corner of the hut is taken up by the gigantic mortar, big enough to stand in. 屋子的一角有一辆巨大的迫击炮，人可以站在里面.

Baba Yaga sits at her work table, sewing symbols into a magic towel.

Baba Yaga正坐在桌边，缝制一条魔法毛巾.

>e towel
I only understood you as far as wanting to (go) e.

>x towel
To judge by the spell worked into its fringes, this is a towel that can turn into a bridge across any river or chasm. 从毛巾的流苏上符文来看，这个毛巾可以在你遇到河流或者深坑的时候变成桥

>take towel
That seems to belong to Baba Yaga.

>fuck Baba
That's not a verb I recognise.

>kill Baba
Violence isn't the answer to this one.

>say Baba
(to Baba Yaga)
There is no reply.

>drop ball
The ball rolls around uncertainly and then comes back to sit at your feet with such an apologetic air that you have to pick it back up. 这只球在地上不知所措地绕圈，不一会它自己又慢慢滚回你的脚边，似乎在表达深深的歉意，你心疼地捡起了球。

>l mortar
Baba Yaga flies around inside it whenever she is in too much of a hurry to make her hut walk, 当Baba Yaga 来不及让他的棚屋走动时，她就用这个迫击炮对外射击.

>in mortar
I only understood you as far as wanting to (go) in.

>get in mortar
"Oh, I wouldn't do that, Foolish Ivan," says Baba Yaga. "Where it would take you, you're not ready to go." 哦，别这么做，傻Ivan,你还没有准备好去它要把你带去的地方。

* * *

Onyx
An Interactive Fiction
Release 1 / Serial number 160326 / Inform 7 build 6M62 (I6/v6.33 lib 6/12N) SD

Deep Forest
You are lost in a deep forest. The trees grow so close together that you cannot see the sun or the sky, and no grass or small plants thrive on the ground. 你迷失在一个幽静的森林里，繁茂的树木甚至遮住了太阳和天空，地上不长草也没有其他小型植物

>look
Deep Forest
You are lost in a deep forest. The trees grow so close together that you cannot see the sun or the sky, and no grass or small plants thrive on the ground. 你迷失在一个幽静的森林里，繁茂的树木甚至遮住了太阳和天空，地上不长草也没有其他小型植物

>look around
You can't see any such thing.

>ll
That's not a verb I recognise.

>ls
That's not a verb I recognise.

>inventroy
That's not a verb I recognise.

>l inventory
You can't see any such thing.

>inventory
You are carrying:
  a magic ball

>i
You are carrying:
  a magic ball

>i
You are carrying:
  a magic ball

* * *

Onyx
An Interactive Fiction
Release 1 / Serial number 160326 / Inform 7 build 6M62 (I6/v6.33 lib 6/12N) SD

Deep Forest
You are lost in a deep forest. The trees grow so close together that you cannot see the sun or the sky, and no grass or small plants thrive on the ground. 你迷失在一个幽静的森林里，繁茂的树木甚至遮住了太阳和天空，地上不长草也没有其他小型植物

>w
Baba Yaga's Garden
In this garden grow plants that eat insects and plants that eat birds. It is bordered by a bone fence, and the pavements are made of a giant's kneecaps.

In the center of the garden is Baba Yaga's hut, which walks on chicken legs. Currently the hut is squatting on the ground.

>take hut
You can't see any such thing.

>c
That's not a verb I recognise.

>center
That's not a verb I recognise.

>x Baba Yaga's hut
You can't see any such thing.

>go Baba Yaga's hut
You can't see any such thing.

>go hut
You can't see any such thing.

>lool
That's not a verb I recognise.

>l
Baba Yaga's Garden
In this garden grow plants that eat insects and plants that eat birds. It is bordered by a bone fence, and the pavements are made of a giant's kneecaps.

In the center of the garden is Baba Yaga's hut, which walks on chicken legs. Currently the hut is squatting on the ground.

>take inventory
You are carrying:
  a magic ball

>x ball
Whenever you drop this, it rolls in the way you should go.

>drop ball
It rolls suggestively towards the inside. You pick it up again before it can get too far ahead of you.

>west
You can't go that way.

>x me
Some people call you Ivan the Fool, but you pay no attention to their rudeness.

>in
Baba Yaga's Hut
From in here, there is no evidence of the hut's chicken nature except that the wallpaper is made of yellow-white feathers.

One corner of the hut is taken up by the gigantic mortar, big enough to stand in.

Baba Yaga sits at her work table, sewing symbols into a magic towel.

>l baba
Her teeth are made of iron and her eyes can see in the dark. Though she is old, her fingers are nimble, and she has forgotten nothing that she has ever seen.

>x towel
To judge by the spell worked into its fringes, this is a towel that can turn into a bridge across any river or chasm.

>drop ball
The ball rolls around uncertainly and then comes back to sit at your feet with such an apologetic air that you have to pick it back up.

>l mortar
Baba Yaga flies around inside it whenever she is in too much of a hurry to make her hut walk.

>in mortar
I only understood you as far as wanting to (go) in.