Disenchantment Bay
An Interactive Fiction by ywx
Release 1 / Serial number 160326 / Inform 7 build 6M62 (I6/v6.33 lib 6/12N) SD

Cabin
The front of the small cabin is entirely occupied with navigational instruments, a radar display, and radios for calling back to shore. Along each side runs a bench with faded blue vinyl cushions, which can be lifted to reveal the storage space underneath. A glass case against the wall contains several fishing rods. 船舱里全是各种导航仪器，一个雷达显示器，还有和陆上联系的无线电。两侧则是长凳，上面放着褪色的蓝色塑料垫子，这个垫子可以被拿开，从而看到座位下方的储藏空间.一个玻璃罐子放在墙边，里面有几支钓鱼竿。

Scratched windows offer a view of the surrounding bay, and there is a door south to the . A sign taped to one wall announces the menu of tours offered by the Yakutat Charter Boat Company. 透过满是划痕的玻璃窗可以看到港湾周围，南边有一个通向夹板的门。 

The captain sits at the wheel, steering the boat and occasionally checking the radar readout.

>Hello
That's not a verb I recognise.

>look
X

>save
Ok.

* * *

>l
Cabin
The front of the small cabin is entirely occupied with navigational instruments, a radar display, and radios for calling back to shore. Along each side runs a bench with faded blue vinyl cushions, which can be lifted to reveal the storage space underneath. A glass case against the wall contains several fishing rods.

Scratched windows offer a view of the surrounding bay, and there is a door south to the deck. A sign taped to one wall announces the menu of tours offered by the Yakutat Charter Boat Company.

The captain sits at the wheel, steering the boat and occasionally checking the radar readout.

* * *

>open compartment
You open the storage compartment, revealing some nets and a warm Coke.

>l
Cabin
The front of the small cabin is entirely occupied with navigational instruments, a radar display, and radios for calling back to shore. Along each side runs a bench with faded blue vinyl cushions, one of which is currently lifted to allow access to the storage compartment within. A glass case against the wall contains several fishing rods. 小屋里全是各种导航仪器，一个雷达显示器，还有和陆上联系的无线电。两侧则是长凳，上面放着褪色的蓝色塑料垫子,其中一个垫子被拿开了，可以看到下面的储藏空间.一个玻璃罐子放在墙边，里面有几支钓鱼竿。

Scratched windows offer a view of the surrounding bay, and there is a door south to the deck. A sign taped to one wall announces the menu of tours offered by the Yakutat Charter Boat Company.

The captain sits at the wheel, steering the boat and occasionally checking the radar readout.

* * *

>take rod
The glass case isn't open.

>open galss case
You can't see any such thing.

>in bench
I only understood you as far as wanting to (go) in.

>go onto bench
You can't see any such thing.

>sit on bench
You get onto the bench.

>open space
You open the storage compartment, revealing some nets and a warm Coke.

>move the cushions
That's already open.

>close the cushions
They aren't something you can close.

>l coke
You see nothing special about the warm Coke.

>l net
They must have something to do with fish as well. Really, you're just here for the sights.

>l radar
Apparently necessary to avoid the larger icebergs.

The radar display is currently switched on.

>l screen
Phantom lights move across the screen.

>close radar
It isn't something you can close.

>switch off radar
You switch the radar display off.

>l captain
The Captain is wearing a baseball cap and carrying a small silver key.

>i
You are carrying:
  a backpack (open)
    a warm beer
  a pair of sunglasses (being worn)

>ask captain for key
"Sure, you can -- well, get me a drink first, would you?"

>give beer to captain
(first taking the warm beer)
"I don't drink on the job, thanks," he says. "You can help yourself if you want it, though."

>take coke
Taken.

>give coke to captain
"It needs chilling," the Captain remarks, disgruntled.

>beer
That's not a verb I recognise.

>l coke
You see nothing special about the warm Coke.

>l bear
You can't see any such thing.

>l beer
You see nothing special about the warm beer.

>get net
(putting the warm beer into the backpack to make room)
Taken.

>s
(first opening the cabin door)
(first getting off the bench)

Deck
The whole back half of the boat is open, allowing you to view the surroundings without intervening windows -- if you can stand the cold.

A very heavy ice chest sits on the ground.

All around the boat bob chunks of glacier ice.

>g
You can't go that way.

>open chest
You open the ice chest.

>i
You are carrying:
  some nets
  a warm Coke
  a backpack (open)
    a warm beer
  a pair of sunglasses (being worn)

>get  ice
Which do you mean, the ice chest or the glacier ice?

>get glacier
That's hardly portable.

>i
You are carrying:
  some nets
  a warm Coke
  a backpack (open)
    a warm beer
  a pair of sunglasses (being worn)

>get glacier ice
You scoop up the ice with the net.

>g
(putting the warm Coke into the backpack to make room)
Taken.

>i
You are carrying:
  a glacier ice
  some nets
  a backpack (open)
    a warm Coke
    a warm beer
  a pair of sunglasses (being worn)

>g
You are carrying:
  a glacier ice
  some nets
  a backpack (open)
    a warm Coke
    a warm beer
  a pair of sunglasses (being worn)

>g
You are carrying:
  a glacier ice
  some nets
  a backpack (open)
    a warm Coke
    a warm beer
  a pair of sunglasses (being worn)

>put glacier ice into chest
You put the glacier ice into the ice chest.

>put coke in chest
(first taking the warm Coke)
You put the warm Coke into the ice chest.

>i chest
I only understood you as far as wanting to take inventory.

>l chest
In the ice chest are a room temperature Coke and a glacier ice.

>get glacier ice
Taken.

>g
You already have that.

>g
You already have that.

>put ice into chest
(the glacier ice into the ice chest)
You put the glacier ice into the ice chest.

>l coke
You see nothing special about the cold Coke.

>get coke
Taken.

>n
Cabin
The front of the small cabin is entirely occupied with navigational instruments, a radar display, and radios for calling back to shore. Along each side runs a bench with faded blue vinyl cushions, one of which is currently lifted to allow access to the storage compartment within. A glass case against the wall contains several fishing rods. 船舱里全是各种导航仪器，一个雷达显示器，还有和陆上联系的无线电。两侧则是长凳，上面放着褪色的蓝色塑料垫子,其中一个垫子被拿开了，可以看到下面的储藏空间.一个玻璃罐子放在墙边，里面有几支钓鱼竿。

Scratched windows offer a view of the surrounding bay, and there is a door south to the deck. A sign taped to one wall announces the menu of tours offered by the Yakutat Charter Boat Company. 透过满是划痕的玻璃窗可以看到港湾周围，南边有一个通向夹板的门。 

The captain sits at the wheel, steering the boat and occasionally checking the radar readout.

>give coke to captain
"Ah, thank you," he says. How he can drink an iced soda on a day like today is an open question, but Alaskans are special.

[Your score has just gone up by two points.]

>open ice
You can't see any such thing.

>open glass
(first unlocking the glass case)
You lack a key that fits the glass case.

>ask captain for key
"Here, knock yourself out."

>open glass
(first unlocking the glass case)
(with the small silver key)
You open the glass case.

>i
You are carrying:
  a small silver key
  some nets
  a backpack (open)
    a warm beer
  a pair of sunglasses (being worn)

>l case
In the glass case is a collection of fishing rods.

>take rod
(putting the nets into the backpack to make room)
Success is yours! (Now if only you knew anything about fishing.)

    *** The End ***

In that game you scored 5 out of a possible 5, in 48 turns.

Would you like to RESTART, RESTORE a saved game, QUIT or UNDO the last command?

* * *

>test fisrt
>--> The following tests are available:
'test me'
'test first'
'test second'
'test third'

>test first
(Testing.)

>[1] x captain
The Captain is wearing a baseball cap and carrying a small silver key.

>[2] open case
(first unlocking the glass case)
You lack a key that fits the glass case.

>[3] i
You are carrying:
  a backpack (open)
    a warm beer
  a pair of sunglasses (being worn)

>[4] ask captain for the key
"Sure, you can -- well, get me a drink first, would you?"

>[5] give beer to captain
(first taking the warm beer)
"I don't drink on the job, thanks," he says. "You can help yourself if you want it, though."

>[6] open bench
You open the storage compartment, revealing some nets and a warm Coke.

>[7] x nets
They must have something to do with fish as well. Really, you're just here for the sights.

>[8] get nets
Taken.

>[9] get coke
(putting the warm beer into the backpack to make room)
Taken.

>[10] give coke to captain
"It needs chilling," the Captain remarks, disgruntled.

* * *

>x captain
The Captain is wearing a baseball cap and carrying a small silver key.

>lift cushion
That's not a verb I recognise.

>move cushion
You can't see any such thing.

>take cushion
You can't see any such thing.

>open compartment
You open the storage compartment, revealing some nets and a warm Coke.