hello, welcome to this game. This game is developed by ywx for a test. if you never play this kind of game before. you can ask for help. 
mygame
An Interactive Fiction by ywx
Release 1 / Serial number 160326 / Inform 7 build 6M62 (I6/v6.33 lib 6/12N) SD

White room
the room is white and empty, only with elm talble in the center. You don't know why you are here, you desire to go out. 

to the south is black room

You can see an iron door, a sword and elm table (on which is key) here.

>ask
What do you want to ask yourself for?

>ask myself for mikl
You can't see any such thing.

>ask myself for
What do you want to ask yourself for?

>s
You must name something more substantial.

>s
(first opening the iron door)

black room
the room is black and dimmed stuffed with gloomy atmosphere, you don't like to stay here for long.

You can see an iron door and wooden box (in which is a bottle of milk) here.

>n
White room
the room is white and empty, only with elm talble in the center. You don't know why you are here, you desire to go out. 

to the south is black room

You can see an iron door, a sword and elm table here.

>take mik
You can't see any such thing.

>take milk
You can't see any such thing.

>l
White room
the room is white and empty, only with elm talble in the center. You don't know why you are here, you desire to go out. 

to the south is black room

You can see an iron door, a sword and elm table here.

>s
black room
the room is black and dimmed stuffed with gloomy atmosphere, you don't like to stay here for long.

You can see an iron door and wooden box (in which is a bottle of milk) here.

>take milk
Taken.

>s
orange room
The room is painted totally orange. 

there is a strange button on the wall

You can also see Cao ye here.

>show cao milk
Cao ye is unimpressed.

>ask cao
(for the bottle of milk)
(Cao ye first taking the bottle of milk)
Cao ye has better things to do.

>ask
(Cao ye for the bottle of milk)
(Cao ye first taking the bottle of milk)
Cao ye has better things to do.

>ask
(Cao ye for the bottle of milk)
(Cao ye first taking the bottle of milk)
Cao ye has better things to do.

>waht
That's not a verb I recognise.

>ask cao for milk
(Cao ye first taking the bottle of milk)
Cao ye has better things to do.

>ask cao for hat
Cao ye: thanks for the milk, take this.

what

* * *

hello, welcome to this game. This game is developed by ywx for a test. if you never play this kind of game before. you can ask for help. 
mygame
An Interactive Fiction by ywx
Release 1 / Serial number 160326 / Inform 7 build 6M62 (I6/v6.33 lib 6/12N) SD

White room
the room is white and empty, only with elm talble in the center. You don't know why you are here, you desire to go out. 

to the south is black room

You can see an iron door, a sword and elm table (on which is key) here.

>d
You can't go that way.

>s
(first opening the iron door)

black room
the room is black and dimmed stuffed with gloomy atmosphere, you don't like to stay here for long.

You can see an iron door and wooden box (in which is a bottle of milk) here.

>s
orange room
The room is painted totally orange. 

You can see Cao ye here.

>Cao
That's not a verb I recognise.

>l cao
Cao ye is a man who experienced years of wind and frost. You have a feeling of deja vu on him.

>l hat
an old worn top hat.

* * *

>s
(first opening the iron door)

black room
the room is black and dimmed stuffed with gloomy atmosphere, you don't like to stay here for long.

You can see an iron door and wooden box (in which is a bottle of milk) here.

>take milk
Taken.

* * *

>s
orange room
The room is painted totally orange. 

there is a strange button on the wall

You can also see Cao ye here.

>ask cao
(for the bottle of milk)
(Cao ye first taking the bottle of milk)
Cao ye has better things to do.

>i
You are carrying:
  a bottle of milk

>ask cao for hat
Cao ye: thanks for the milk, take this.

(Cao ye first taking the top hat)
Cao ye has better things to do.

* * *

hello, welcome to this game. This game is developed by ywx for a test. if you never play this kind of game before. you can ask for help. 
mygame
An Interactive Fiction by ywx
Release 1 / Serial number 160326 / Inform 7 build 6M62 (I6/v6.33 lib 6/12N) SD

White room
the room is white and empty, only with elm talble in the center. You don't know why you are here, you desire to go out. 

to the south is black room

You can see an iron door, a sword and elm table (on which is key) here.

>help
That's not a verb I recognise.

>h
That's not a verb I recognise.

* * *

hello, welcome to this game. This game is developed by ywx for a test. if you never play this kind of game before. you can ask for help. 
mygame
An Interactive Fiction by ywx
Release 1 / Serial number 160326 / Inform 7 build 6M62 (I6/v6.33 lib 6/12N) SD

White room
the room is white and empty, only with elm talble in the center. You don't know why you are here, you desire to go out. 

to the south is black room

You can see an iron door, a sword and elm table (on which is key) here.

>l
White room
the room is white and empty, only with elm talble in the center. You don't know why you are here, you desire to go out. 

to the south is black room

You can see an iron door, a sword and elm table (on which is key) here.

>go out
You can't go that way.

* * *

>l
White room
the room is white and empty, only with elm talble in the center. You don't know why you are here, you desire to go out. 

to the south is black room

You can see an iron door, a sword and elm table (on which is key) here.

>i
You are carrying nothing.

>kill myself
Violence isn't the answer to this one.

>heal
That's not a verb I recognise.

>l
Example Location
hhdsajfh

>e
You can't go that way.

* * *

>l
White room
the room is white and empty, only with elm talble in the center. You don't know why you are here, you desire to go out. 

to the south is black room

You can see an iron door, a sword and elm table (on which is key) here.

>l
Example Location

* * *

>l
White room
the room is white and empty, only with elm talble in the center. You don't know why you are here, you desire to go out. 

to the south is black room

You can see an iron door, a sword and elm table (on which is key) here.

>s
(first opening the iron door)

black room
the room is black and dimmed stuffed with gloomy atmosphere, you don't like to stay here for long.

You can see an iron door and wooden box (empty) here.

>l door
You see nothing special about the iron door.

>enter door
White room
the room is white and empty, only with elm talble in the center. You don't know why you are here, you desire to go out. 

to the south is black room

You can see an iron door, a sword and elm table here.

>enter door
black room
the room is black and dimmed stuffed with gloomy atmosphere, you don't like to stay here for long.

You can see an iron door and wooden box (empty) here.

* * *

>s
(first opening the iron door)

black room
the room is black and dimmed stuffed with gloomy atmosphere, you don't like to stay here for long.

You can see an iron door and wooden box (empty) here.

>s
orange room
The room is painted totally orange. 

You can see Cao ye here.

>greet
That's not a verb I recognise.

>hi
That's not a verb I recognise.

>say Cao
(to Cao ye)
There is no reply.

>kill Cao
Violence isn't the answer to this one.

>l Cao
Cao ye is a man who experienced years of wind and frost. You have a feeling of deja vu on him.

* * *

hello, welcome to this game. This game is developed by ywx for a test. if you never play this kind of game before. you can ask for help. 
mygame
An Interactive Fiction by ywx
Release 1 / Serial number 160326 / Inform 7 build 6M62 (I6/v6.33 lib 6/12N) SD

White room
the room is white and empty, only with elm talble in the center. You don't know why you are here, you desire to go out. 

to the south is black room

You can see an iron door, a sword and elm table (on which is key) here.

>l door
You see nothing special about the iron door.

>close door
That's already closed.

>s
(first opening the iron door)

black room
the room is black and dimmed stuffed with gloomy atmosphere, you don't like to stay here for long.

You can see an iron door here.

>close door
You close the iron door.

>n
(first opening the iron door)

White room
the room is white and empty, only with elm talble in the center. You don't know why you are here, you desire to go out. 

to the south is black room

You can see an iron door, a sword and elm table here.

* * *

hello, welcome to this game. This game is developed by ywx for a test. if you never play this kind of game before. you can ask for help. 
mygame
An Interactive Fiction by ywx
Release 1 / Serial number 160326 / Inform 7 build 6M62 (I6/v6.33 lib 6/12N) SD

White room
the room is white and empty, only with elm talble in the center. You don't know why you are here, you desire to go out. 

to the south is black room

You can see an iron door, a sword and elm table (on which is key) here.

>l ke
You can't see any such thing.

>l key
a small key

* * *

hello, welcome to this game. This game is developed by ywx for a test. if you never play this kind of game before. you can ask for help. 
mygame
An Interactive Fiction by ywx
Release 1 / Serial number 160326 / Inform 7 build 6M62 (I6/v6.33 lib 6/12N) SD

White room
the room is white and empty, only with elm talble in the center. You don't know why you are here, you desire to go out. 

to the south is black room

You can see an iron door, a sword and elm table (on which is key) here.

>n
You can't go that way.

>s
You can't go that way.

>s
You can't go that way.

>open door
You can't see any such thing.

>l door
You can't see any such thing.

>s
You can't go that way.

* * *

>open door
You can't see any such thing.

>s
You can't go that way.

>l door
You can't see any such thing.

>door
That's not a verb I recognise.

>close door
You can't see any such thing.

* * *

>s
You can't go that way.

>w
You can't go that way.

>e
You can't go that way.

>s
You can't go that way.

* * *

>open door
You can't see any such thing.

>open iron door
You can't see any such thing.

* * *

hello, welcome to this game. This game is developed by ywx for a test. if you never play this kind of game before. you can ask for help. 
mygame
An Interactive Fiction by ywx
Release 1 / Serial number 160326 / Inform 7 build 6M62 (I6/v6.33 lib 6/12N) SD

White room
the room is white and empty, only with elm talble in the center. You don't know why you are here, you desire to go out. 

to the south is black room

You can see an iron door, a sword and elm table (on which is key) here.

>s
(first opening the iron door)
It seems to be locked.

>n
White room
the room is white and empty, only with elm talble in the center. You don't know why you are here, you desire to go out. 

to the south is black room

You can see an iron door, a sword and elm table here.

>e
You can't go that way.

>w
You can't go that way.

>open door
You can't see any such thing.

* * *

>n
White room
the room is white and empty, only with elm talble in the center. You don't know why you are here, you desire to go out. 

to the south is black room

You can see an iron door, a sword and elm table here.

>l
whilte room
You can see an iron door here.

>l
whilte room
You can see an iron door here.

>l wihte door
You can't see any such thing.

* * *

>n
White room
the room is white and empty, only with elm talble in the center. You don't know why you are here, you desire to go out. 

to the south is black room

You can see an iron door, a sword and elm table here.

>l s
You see nothing unexpected in that direction.

>l door
You see nothing special about iron door.

>open door
That's already open.

>close door
You close iron door.

>l
whilte room
You can see iron door here.

>s
(first opening iron door)

black room
the room is black and dimmed stuffed with gloomy atmosphere, you don't like to stay here for long.

You can see iron door here.

* * *

>n
White room
the room is white and empty, only with elm talble in the center. You don't know why you are here, you desire to go out. 

to the south is black room

You can see an iron door, a sword and elm table here.

>n
You can't go that way.

>s
black room
the room is black and dimmed stuffed with gloomy atmosphere, you don't like to stay here for long.

You can see an iron door here.

>n
White room
the room is white and empty, only with elm talble in the center. You don't know why you are here, you desire to go out. 

to the south is black room

You can see an iron door, a sword and elm table here.

>s
black room
the room is black and dimmed stuffed with gloomy atmosphere, you don't like to stay here for long.

You can see an iron door here.

>n
whilte room
You can see an iron door here.

>s
black room
the room is black and dimmed stuffed with gloomy atmosphere, you don't like to stay here for long.

You can see an iron door here.

* * *

>s
(first opening the iron door)
It seems to be locked.

>s
(first opening the iron door)
It seems to be locked.

>black room
That's not a verb I recognise.

* * *

>s
(first opening the iron door)
It seems to be locked.

>l Cao
Cao ye is a man who experienced years of wind and frost. You have a feeling of deja vu on him.

* * *

>s
(first opening the iron door)
It seems to be locked.

>l button
You see nothing special about button.

* * *

>s
(first opening the iron door)
It seems to be locked.

>open door
You can't see any such thing.

* * *

>s
(first opening the iron door)
It seems to be locked.

>ask cao for hat
no
Cao ye has better things to do.

* * *

>s
(first opening the iron door)
It seems to be locked.

>e
You can't go that way.

>e
You can't go that way.

>s
(first opening the iron door)
It seems to be locked.

>take key
Taken.

>unlock door
(with key)
You unlock the iron door.

>s
(first opening the iron door)

black room
the room is black and dimmed stuffed with gloomy atmosphere, you don't like to stay here for long.

You can see an iron door and wooden box (in which is a bottle of milk) here.

>s
orange room
The room is painted totally orange. 

there is a strange button on the wall

You can also see Cao ye here.

>e
green room

* * *

>s
(first opening the iron door)
It seems to be locked.

>n
You can't go that way.

* * *

>s
(first opening the iron door)
It seems to be locked.

>s
You can't go that way.

* * *

>s
(first opening the iron door)
It seems to be locked.

>take hat
That seems to belong to Cao ye.

>ask cao for hat
Cao ye has better things to do.

* * *

>s
(first opening the iron door)
It seems to be locked.

>take button
Taken.

* * *

>s
(first opening the iron door)
It seems to be locked.

>take button
You can't see any such thing.

>s
orange room
The room is painted totally orange. 

there is a strange button on the wall

You can also see Cao ye here.

>take button
the buttton is fixed on the wall

>l
orange room
The room is painted totally orange. 

there is a strange button on the wall

You can also see Cao ye here.

>i
You are carrying nothing.

>read
What do you want to read?

>read book
You can't see any such thing.

>showme
orange room - room
    yourself - person
    Cao ye - man
        top hat (worn)
    button

>show me cao
(first taking Cao ye)
I don't suppose Cao ye would care for that.

>showme cao
Cao ye - man
    top hat (worn)
location: in orange room
singular-named, proper-named; unlit, inedible, portable; male
list grouping key: none
printed name: "Cao ye"
printed plural name: "men"
indefinite article: none
description: "Cao ye is a man who experienced years of wind and frost. You have a feeling of deja vu on him. he wears a top hat"
initial appearance: none
carrying capacity: 100

>test
>--> No test scripts exist for this game.

>undo
orange room
[Previous turn undone.]

* * *

>s
(first opening the iron door)
It seems to be locked.

>take milk
Taken.

* * *

>s
orange room
The room is painted totally orange. 

there is a strange button on the wall

You can also see Cao ye here.

>ask cao for hat
Cao ye: thanks for the milk, take this.

>ask cao
(for the top hat)
no

>ask cao
(for the top hat)
no

>ask no
You can't see any such thing.

>say cao
(to Cao ye)
There is no reply.

>ask cao for h
You can't see any such thing.

* * *

>s
(first opening the iron door)
It seems to be locked.

>walk south
You can't go that way.

* * *

hello, welcome to this game. This game is developed by ywx for a test. if you never play this kind of game before. you can ask for help. 
mygame
An Interactive Fiction by ywx
Release 1 / Serial number 160326 / Inform 7 build 6M62 (I6/v6.33 lib 6/12N) SD

White room
the room is white and empty, only with elm talble in the center. You don't know why you are here, you desire to go out. 

to the south is black room

You can see an iron door, a sword and elm table (on which is key) here.

>s s
(first opening the iron door)

black room
the room is black and dimmed stuffed with gloomy atmosphere, you don't like to stay here for long.

You can see an iron door and wooden box (in which is a bottle of milk) here.

>s
orange room
The room is painted totally orange. 

You can see Cao ye here.

>l
orange room
The room is painted totally orange. 

You can see Cao ye here.

>l
orange room
The room is painted totally orange. 

You can see Cao ye here.

>l button
You can't see any such thing.

* * *

hello, welcome to this game. This game is developed by ywx for a test. if you never play this kind of game before. you can ask for help. 
mygame
An Interactive Fiction by ywx
Release 1 / Serial number 160326 / Inform 7 build 6M62 (I6/v6.33 lib 6/12N) SD

White room
the room is white and empty, only with elm talble in the center. You don't know why you are here, you desire to go out. 

to the south is black room

You can see an iron door, a sword and elm table (on which is key) here.

>take key
Taken.

>drop key
Dropped.

>l
White room
the room is white and empty, only with elm talble in the center. You don't know why you are here, you desire to go out. 

to the south is black room

You can see key, an iron door, a sword and elm table here.

>s
(first opening the iron door)
It seems to be locked.

>open
What do you want to open?

>door
It seems to be locked.

>take key
Taken.

>open door
It seems to be locked.

>use key to open door
That's not a verb I recognise.

>unlock door
(with key)
That doesn't seem to fit the lock.

>unlock door with key
That doesn't seem to fit the lock.

* * *

>open door
It seems to be locked.

>unlock door
(with key)
You unlock the iron door.

* * *

>s
orange room
The room is painted totally orange. 

there is a strange button on the wall

You can also see Cao ye here.

>s
You can't go that way.

* * *

hello, welcome to this game. This game is developed by ywx for a test. if you never play this kind of game before. you can ask for help. 
mygame
An Interactive Fiction by ywx
Release 1 / Serial number 160326 / Inform 7 build 6M62 (I6/v6.33 lib 6/12N) SD

White room
the room is white and empty, only with elm talble in the center. You don't know why you are here, you desire to go out. 

to the south is black room

You can see an iron door, a sword and elm table (on which is key) here.

>take key & unlock door
I only understood you as far as wanting to take key.

>unlock door
What do you want to unlock the iron door with?

>with key
You can't see any such thing.

>take key
Taken.

* * *

>s
You can't go that way.

>e
green room
a room in shiny green

>l
green room
a room in shiny green

>l
green room
a room in shiny green

* * *

hello, welcome to this game. This game is developed by ywx for a test. if you never play this kind of game before. you can ask for help. 
mygame
An Interactive Fiction by ywx
Release 1 / Serial number 160326 / Inform 7 build 6M62 (I6/v6.33 lib 6/12N) SD

White room
the room is white and empty, only with elm talble in the center. You don't know why you are here, you desire to go out. 

to the south is black room

You can see an iron door, a sword and elm table (on which is key) here.

>take sword
you take the sword and you find something written on the balde.

>i
You are carrying:
  a sword

>l sword
the sword is light in you hand with thrilling silver blade.on the blade written "8732"

* * *

>take sword
you take the sword and you find something written on the balde.

>take sword
You already have that.

>drop sword
Dropped.

>take sword
you take the sword and you find something written on the balde.

* * *

hello, welcome to this game. This game is developed by ywx for a test. if you never play this kind of game before. you can ask for help. 
mygame
An Interactive Fiction by ywx
Release 1 / Serial number 160326 / Inform 7 build 6M62 (I6/v6.33 lib 6/12N) SD

White room
the room is white and empty, only with elm talble in the center. You don't know why you are here, you desire to go out. 

to the south is black room

You can see an iron door, a sword and elm table (on which is key) here.

>take table
That's fixed in place.

>hit
What do you want to hit?

>hit table
Violence isn't the answer to this one.

>l table
it's a heavy table.

>l
White room
the room is white and empty, only with elm talble in the center. You don't know why you are here, you desire to go out. 

There is a door lead to south.

You can see a sword and elm table here.

>l
White room
the room is white and empty, only with elm talble in the center. You don't know why you are here, you desire to go out. 

There is a door lead to south.

You can see a sword and elm table here.

>s
black room
the room is black and dimmed stuffed with gloomy atmosphere, you don't like to stay here for long.

You can see an iron door here.

>n
(first opening the iron door)

whilte room
You can see an iron door here.

* * *

hello, welcome to this game. This game is developed by ywx for a test. if you never play this kind of game before. you can ask for help. 
mygame
An Interactive Fiction by ywx
Release 1 / Serial number 160326 / Inform 7 build 6M62 (I6/v6.33 lib 6/12N) SD

White room
the room is white and empty, only with elm talble in the center. You don't know why you are here, you desire to go out. 

to the south is black room

You can see an iron door, a sword and elm table (on which is key) here.

>w
You can't go that way.

>s
Black room
the room is black and dimmed stuffed with gloomy atmosphere, you don't like to stay here for long.

>n
White room
the room is white and empty, only with elm talble in the center. You don't know why you are here, you desire to go out. There is a door lead to south.

* * *

hello, welcome to this game. This game is developed by ywx for a test. if you never play this kind of game before. you can ask for help. 
mygame
An Interactive Fiction by ywx
Release 1 / Serial number 160326 / Inform 7 build 6M62 (I6/v6.33 lib 6/12N) SD

White room
the room is white and empty, only with elm talble in the center. You don't know why you are here, you desire to go out. 

to the south is black room

You can see an iron door, a sword and elm table (on which is key) here.

>x me
you foget who you are.is it strange?